{
	"tiles" : [[1, 1, 0, 1, 1, 1, 0, 1, 1 ],
			   [1, 1, 0, 1, 0, 1, 0, 0, 1 ],
			   [1, 1, 0, 1, 0, 1, 0, 0, 1 ],
			   [1, 1, 0, 1, 0, 1, 0, 0, 1 ],
			   [0, 1, 0, 1, 0, 1, 0, 1, 1 ],
			   [0, 1, 0, 1, 0, 1, 0, 1, 0 ],
			   [0, 1, 0, 1, 0, 1, 0, 1, 0 ],
			   [0, 1, 0, 1, 0, 1, 0, 1, 0 ],
			   [0, 1, 0, 1, 1, 1, 0, 1, 1 ] ],
	
	"targetScore" : 902,
	"moves" : 95,
	"symbols" : 3,
}
