{
	"tiles" : [[1, 1, 1, 1, 1, 1, 1, 1, 1 ],
			   [0, 0, 0, 0, 0, 0, 0, 0, 0 ],
			   [1, 1, 1, 1, 1, 1, 1, 1, 1 ],
			   [1, 1, 1, 1, 1, 1, 1, 1, 1 ],
			   [1, 1, 1, 1, 1, 1, 1, 1, 1 ],
			   [1, 1, 1, 1, 1, 1, 1, 1, 1 ],
			   [1, 1, 1, 1, 1, 1, 1, 1, 1 ],
			   [0, 0, 0, 0, 0, 0, 0, 0, 0 ],
			   [1, 1, 1, 1, 1, 1, 1, 1, 1 ] ],
	
	"targetScore" : 600,
	"moves" : 15,
	"symbols" : 6,
}
