{
	"tiles" : [[1, 1, 1, 0, 0, 0, 1, 1, 1 ],
			   [1, 1, 1, 0, 0, 0, 1, 1, 1 ],
			   [1, 1, 1, 0, 0, 0, 1, 1, 1 ],
			   [0, 0, 0, 0, 0, 0, 0, 0, 0 ],
			   [0, 0, 0, 0, 0, 0, 0, 0, 0 ],
			   [0, 0, 0, 0, 0, 0, 0, 0, 0 ],
			   [1, 1, 1, 0, 0, 0, 1, 1, 1 ],
			   [1, 1, 1, 0, 0, 0, 1, 1, 1 ],
			   [1, 1, 1, 0, 0, 0, 1, 1, 1 ] ],
	
	"targetScore" : 300,
	"moves" : 10,
}
