{
	"tiles" : [[1, 1, 1, 1, 1, 1, 1, 1, 1 ],
			   [1, 0, 0, 1, 0, 1, 0, 0, 1 ],
			   [1, 0, 0, 1, 0, 1, 1, 0, 1 ],
			   [1, 0, 0, 1, 0, 1, 1, 0, 1 ],
			   [1, 1, 0, 1, 0, 1, 1, 0, 1 ],
			   [1, 1, 0, 1, 0, 1, 1, 0, 1 ],
			   [1, 1, 0, 1, 0, 1, 1, 0, 1 ],
			   [1, 1, 0, 1, 0, 1, 1, 0, 1 ],
			   [1, 1, 1, 1, 1, 1, 1, 1, 1 ] ],
	
	"targetScore" : 917,
	"moves" : 93,
	"symbols" : 5,
}
